connect|log|login
time|timestamp|timestamps
print|display|show|see|list|output
output|print|see|display|show
get|output|print|see|display|show|query
query|get|output|print|see|display|show
show|print|display|see
edit|see|show
make|create
delete|erase|remove|removes
erase|remove
arch|architecture
dir|directory|folder|directories
folder|directory|dir|directories
display|screen|terminal|print|show
terminal|screen
login|connect|log
download|downloader
downloader|download
network|web|internet
web|network|internet
internet|web|network
os|operating-system|system|machine
system|os|server|machine
machine|system|server
server/system/machine
modify|change|changes
change|modify
know|print|display|show|tell
see|print|show|display|output
part|line
line|part|string|text|characters
characters|text|string
text|characters|string
string|line|characters|text
command|program
program|command
execute|run
run|execute
periodically|every
every|periodically
env|environment|environmental
environment|env|environmental
storage|buffer|disk
buffer|storage
info|information|content
information|content
stream|flow
flow|stream
concatinatae|concatenate|concat
halt|shutdown|poweroff|reboot
shutdown|halt|poweroff|reboot
poweroff|halt|shutdown
reboot|halt
